0 7 7 7 7 7 7 7 7 7 7 0
7 0 7 10 10 1 10 10 7 0 7 0
0 0 10 10 10 6 6 10 10 10 0 0
0 0 0 10 10 1 10 10 0 0 0 0
0 7 0 0 7 10 10 7 0 0 7 0
0 7 7 7 7 7 7 7 7 7 0 0
1 1 0 1 1 0 1 1 0 1 1 0
0 6 6 0 6 6 0 6 6 0 6 0
1 1 0 1 1 0 1 1 0 1 1 0
0 0 0 0 0 0 0 0 0 0 0 0
0 0 0 0 0 0 0 0 0 0 0 0
0 0 0 0 0 0 0 0 0 0 0 0
0 0 0 0 0 0 0 0 0 0 0 0
0 0 0 0 0 0 0 0 0 0 0 0
0 0 0 0 0 0 0 0 0 0 0 0
0 0 0 0 0 0 0 0 0 0 0 0
0 0 0 0 0 0 0 0 0 0 0 0