1 5 5 5 0 5 5 0 5 5 5 1
6 6 0 6 6 10 6 6 0 6 6 0
1 5 5 5 0 5 5 0 5 5 5 1
3 1 6 3 1 6 3 1 6 3 1 6
1 6 3 0 5 0 0 6 0 3 6 1
5 0 1 0 1 0 1 0 1 0 5 0
0 6 0 0 3 0 0 3 0 0 6 0
0 3 1 6 0 0 0 6 1 3 0 0
0 6 0 3 0 0 0 0 3 0 6 0
0 5 1 0 0 0 0 0 1 5 0 0
0 6 0 3 0 0 0 0 3 0 6 0
0 5 1 0 0 0 0 0 1 5 0 0
0 10 0 0 0 0 0 0 10 0 0 0
0 0 0 0 0 0 0 0 0 0 0 0
0 0 0 0 0 0 0 0 0 0 0 0
0 0 0 0 0 0 0 0 0 0 0 0
0 0 0 0 0 0 0 0 0 0 0 0